100
w,w,w,w,w,w,w,w,
w,.,.,12,.,.,o6,w,
w,.,b6,.,.,.,32,w,
w,.,o,.,o,.,.,w,
w,.,s,21,.,s,p,w,
w,.,.,.,.,.,.,w,
w,.,23,.,.,.,.,w,
w,w,w,w,w,w,w,w,