100
w,w,w,w,w,w,w,w,
w,.,.,12,.,.,o6,w,
w,.,b6,.,.,.,32,w,
w,.,o,.,o,.,.,w,
w,.,s,21,.,s,.,w,
w,.,.,.,.,.,.,w,
w,.,23,.,p,.,.,w,
w,w,w,w,w,w,w,w,